15 30 7
6 11
??????????????????????????????
??????????????????????????????
??????????????????????????????
??????????????????????????????
???###########????????????????
???###########????????????????
???##T......C#????????????????
???###########????????????????
???###########????????????????
??????????????????????????????
??????????????????????????????
??????????????????????????????
??????????????????????????????
??????????????????????????????
??????????????????????????????